111050111111111111111111111111111111111111111111111111111111111111111111111111111111111111111
111000111111111111111111111111111111111111111111111111111111111111111111111111111111111111111
111000111111111111111111111111111111111111111111111111111111111111111111111111111111111111111
111000000000111000000000111000000000000000000000111000000000000000000000000000000000000000111
111000000000111000000000111000000000000000000000111000000000000000000000000000000000000000111
111000000000111000000000111000000000000000000000111000000000000000000000000000000000000000111
111111111000111000111000111000111111111000111000111000111111111000111111111111111111111000111
111111111000111000111000111000111111111000111000111000111111111000111111111111111111111000111
111111111000111000111000111000111111111000111000111000111111111000111111111111111111111000111
111000000000111000111000111000111000000000111000000000111000000000111000000000000000000000111
111000000000111000111000111000111000000000111000000000111000000000111000000000000000000000111
111000000000111000111000111000111000000000111000000000111000000000111000000000000000000000111
111000111111111111111000111000111111111000111111111111111000111111111111111111111000111111111
111000111111111111111000111000111111111000111111111111111000111111111111111111111000111111111
111000111111111111111000111000111111111000111111111111111000111111111111111111111000111111111
111000111000000000111000000000111000000000111000000000000000111000000000111000000000111000111
111000111000000000111000000000111000000000111000000000000000111000000000111000000000111000111
111000111000000000111000000000111000000000111000000000000000111000000000111000000000111000111
111000111111111000111111111000111000111111111000111111111111111000111000111000111111111000111
111000111111111000111111111000111000111111111000111111111111111000111000111000111111111000111
111000111111111000111111111000111000111111111000111111111111111000111000111000111111111000111
111000111000000000000000000000111000000000111000000000000000111000111000111000111000000000111
111000111000000000000000000000111000000000111000000000000000111000111000111000111000000000111
111000111000000000000000000000111000000000111000000000000000111000111000111000111000000000111
111000111000111000111111111111111111111000111111111111111000111000111000111000111111111000111
111000111000111000111111111111111111111000111111111111111000111000111000111000111111111000111
111000111000111000111111111111111111111000111111111111111000111000111000111000111111111000111
111000000000111000000000000000000000111000111000000000000000111000111000111000111000000000111
111000000000111000000000000000000000111000111000000000000000111000111000111000111000000000111
111000000000111000000000000000000000111000111000000000000000111000111000111000111000000000111
111111111111111111111111111111111111111000111000111111111111111000111000111000111000111111111
111111111111111111111111111111111111111000111000111111111111111000111000111000111000111111111
111111111111111111111111111111111111111000111000111111111111111000111000111000111000111111111
111000000000111000000000111000111000000000111000000000111000000000111000111000000000111000111
111000000000111000000000111000111000000000111000000000111000000000111000111000000000111000111
111000000000111000000000111000111000000000111000000000111000000000111000111000000000111000111
111000111000111000111000111000111000111111111111111000111000111111111000111111111111111000111
111000111000111000111000111000111000111111111111111000111000111111111000111111111111111000111
111000111000111000111000111000111000111111111111111000111000111111111000111111111111111000111
111000111000111000111000000000000000111000000000111000111000000000111000000000000000111000111
111000111000111000111000000000000000111000000000111000111000000000111000000000000000111000111
111000111000111000111000000000000000111000000000111000111000000000111000000000000000111000111
111000111000111000111111111111111111111000111000111000111111111111111111111111111000111000111
111000111000111000111111111111111111111000111000111000111111111111111111111111111000111000111
111000111000111000111111111111111111111000111000111000111111111111111111111111111000111000111
111000111000111000000000000000111000000000111000111000000000000000000000111000111000000000111
111000111000111000000000000000111000000000111000111000000000000000000000111000111000000000111
111000111000111000000000000000111000000000111000111000000000000000000000111000111000000000111
111000111000111111111111111000111000111111111111111111111111111111111000111000111111111000111
111000111000111111111111111000111000111111111111111111111111111111111000111000111111111000111
111000111000111111111111111000111000111111111111111111111111111111111000111000111111111000111
111000111000000000000000111000111000111000000000000000000000000000000000111000000000000000111
111000111000000000000000111000111000111000000000000000000000000000000000111000000000000000111
111000111000000000000000111000111000111000000000000000000000000000000000111000000000000000111
111000111111111111111111111000111000111000111000111111111111111111111111111000111111111111111
111000111111111111111111111000111000111000111000111111111111111111111111111000111111111111111
111000111111111111111111111000111000111000111000111111111111111111111111111000111111111111111
111000000000000000000000000000111000111000111000000000111000000000000000000000000000111000111
111000000000000000000000000000111000111000111000000000111000000000000000000000000000111000111
111000000000000000000000000000111000111000111000000000111000000000000000000000000000111000111
111111111111111111111111111111111000111111111111111000111000111111111111111000111000111000111
111111111111111111111111111111111000111111111111111000111000111111111111111000111000111000111
111111111111111111111111111111111000111111111111111000111000111111111111111000111000111000111
111000000000000000111000000000000000111000000000111000111000111000000000111000111000000000111
111000000000000000111000000000000000111000000000111000111000111000000000111000111000000000111
111000000000000000111000000000000000111000000000111000111000111000000000111000111000000000111
111000111111111000111111111000111111111000111111111000111000111000111000111000111111111111111
111000111111111000111111111000111111111000111111111000111000111000111000111000111111111111111
111000111111111000111111111000111111111000111111111000111000111000111000111000111111111111111
111000000000111000000000111000000000111000000000111000000000111000111000111000111000000000111
111000000000111000000000111000000000111000000000111000000000111000111000111000111000000000111
111000000000111000000000111000000000111000000000111000000000111000111000111000111000000000111
111111111000111111111000111111111000111111111000111111111111111111111000111000111111111000111
111111111000111111111000111111111000111111111000111111111111111111111000111000111111111000111
111111111000111111111000111111111000111111111000111111111111111111111000111000111111111000111
111000000000111000111000111000111000111000000000000000000000000000111000000000000000000000111
111000000000111000111000111000111000111000000000000000000000000000111000000000000000000000111
111000000000111000111000111000111000111000000000000000000000000000111000000000000000000000111
111000111000111000111000111000111000111000111000111111111111111000111000111000111111111000111
111000111000111000111000111000111000111000111000111111111111111000111000111000111111111000111
111000111000111000111000111000111000111000111000111111111111111000111000111000111111111000111
111000111000111000111000111000000000000000111000111000000000111000000000111000111000000000111
111000111000111000111000111000000000000000111000111000000000111000000000111000111000000000111
111000111000111000111000111000000000000000111000111000000000111000000000111000111000000000111
111000111111111000111000111111111111111111111000111000111000111111111111111000111000111111111
111000111111111000111000111111111111111111111000111000111000111111111111111000111000111111111
111000111111111000111000111111111111111111111000111000111000111111111111111000111000111111111
111000000000000000111000000000000000000000000000111000111000000000000000000000111000000000111
111000000000000000111000000000000000000000000000111000111000000000000000000000111000000000111
111000000000000000111000000000000000000000000000111000111000000000000000000000111000000000111
111111111111111111111111111111111111111111111111111111111111111111111111111111111111111000111
111111111111111111111111111111111111111111111111111111111111111111111111111111111111111000111
111111111111111111111111111111111111111111111111111111111111111111111111111111111111111020111